WE ./textures/examples2.xpm
C 220, 100, 0



NO ./textures/examples0.xpm
EA              ./textures/examples3.xpm
SO ./textures/examples1.xpm
F 225, 12,                                  12

          111111111111111111111111
          1000000000110000000000001
          1011000001110000000000001
          1001000000000000000000001
11111111111100000111000000000000111
100000000011000001110111111111111
111101111111110111 1000010001
11110111111110011111010010001
11000000110101010100000010001
10000000000000001100000010001
10000000000000001101010010001
1100000111010101111101111N00111
11110111 1110101 101111010001
11111111 1111111 111111111111