     EA              ./textures/examples3.xpm
SO ./textures/examples1.xpm
NO ./textures/examples0.xpm
F 32, 43,                                  54
WE ./textures/examples2.xpm
C 107, 174, 232



     1111111111111111111111111111111
          10000000001100000000000001
          10110000011100000000000001
          10011111100000000000000001
111111111111001   111111111111111111
1000000000110011111
111101111111000111
11110111111100111111111111111
11000000110101010100000010001
10000000000000000000000000001
1000000000000000000101000N001
1100000111010101111101111000111
11110111 1110101 101111010001
11111111 1111111 111111111111