     EA              ./textures/examples3.xpm
SO ./textures/examples1.xpm
NO ./textures/examples0.xpm
F 225, 12,                                  12
WE ./textures/examples2.xpm
C 255,200,0



     1111111111111111111111111111111
          10000000001100000000000001
          10110000011100000000000001
          10011111100000000000000001
111111111111001   111111111111111111
1000000000110011111
111101111111110111
1111011111110011111110010001
11000000110101010100000010001
10000000000000001100000010001
1000000000000000110101001N001
1100000111010101111101111000111
11110111 1110101 101111010001
11111111 1111111 111111111111